1331313131313131313131313114212121212121
2200000000000000000000000030142121133114
2200000000000000000000000000202113320020
2200343300000000000000000000303132000020
2200000000000000000000000000000000000020
2200101111111200101111111200000000000020
2311242121212311242121212200000000000020
2121212121212121212121212200001011111124
2121212121212121133131313200002021212121
2121212121212121220000000000002021212121
2121212121212121231111111111112421212121

image image:tiles
sprite @5,4 sprite:goblin 0x00000000
sprite @17,6 sprite:hero 0x00000000
