2121212113313131313131311421212121212121
2121133132000000000000003031311421212121
2113320000000000000000000000003031311421
1332000000000000000000000000000000003014
2200000000000000000000000000000000000020
2200000000000000000000000000000000000020
2200000000000000001011111111111111111124
2311111111111111112421212121212121212121
2121212121212121212121212121212121212121
2121212121212121212121212121212121212121
2121212121212121212121212121212121212121

image image:3
sprite @5,6 sprite:hero 0x00000000
sprite @2,6 sprite:treasure 0x00000000
sprite @12,5 sprite:goblin 0x00000000
