1331313131313131313131313114212121212121
2200000000000000000000000030142121133114
2200000000000000000000000000202113320020
2200003333000000000000000000303132000020
2200000000000000000000000000000000000020
2200101111111200000000000000000000000020
2311242121212312000000000000000000000020
2121212121212122000000000000000010111124
2121212121212123120000000000001024212121
2121212121212121220000000000002021212121
2121212121212121231111111111112421212121

image image:tiles
sprite @5,4 sprite:goblin 0x00000000
sprite @17,6 sprite:hero 0x00000000
