1331313131313131313131313114212121212121
2200000000000000000000000030142121212121
2200000000000000000000000000303131313114
2200003333000000000000000000000000000020
2200000000000000000000000000000000000020
2200101111111111120000000000000000000020
2311242121212121220000000000000010111124
2121212121212121220000000000000020212121
2121212121212121220000000000000020212121
2121212121212121220000000000000020212121
2121212121212121231200000000001024212121

image image:tiles
sprite @5,4 sprite:goblin 0x00000000
sprite @17,5 sprite:hero 0x00000000
