2121212121212121212121212121212121212121
2121211331313131313131142121212121212121
1331313200000000000000303131311421212121
2200000000000000000000000000003031313114
2200000000000000000000000000000000000020
2200000000000000000000000000000000000020
2200000000001011120000000000000000000020
2200000000002021220000000000000000000020
2311111111112421220000000000000010111124
2121212121212121231111111111111124212121
2121212121212121212121212121212121212121

image image:3
sprite @2,7 sprite:hero 0x00000000
sprite @13,8 sprite:goblin 0x00000000
sprite @17,7 sprite:treasure 0x00000000
sprite @7,5 sprite:goblin 0x00000000
sprite @11,8 sprite:goblin 0x00000000
