1331313131313131313131313131313131313114
2200000000000000000000000000000000000020
2200000000000000000000000000000000000020
2200000000001011120000000000000000000020
2200000000003031320000000000000000000020
2200000000000000000000000000000000000020
2311120000000000000000000000000000101124
2121220000000000000000000000000000202121
2121231112000000000000000000001011242121
2121212122000000000000000000002021212121
2121212123111111111111111111112421212121

image image:3
sprite @10,9 sprite:treasure 0x00000000
sprite @7,2 sprite:hero 0x00000000
sprite @18,5 sprite:goblin 0x00000000
sprite @1,5 sprite:goblin 0x00000000
sprite @3,7 sprite:goblin 0x00000000
sprite @16,7 sprite:goblin 0x00000000
