1331313131313131313131313131313131313114
2200000000000000000000000000000000000020
2200000000000000000000000000000000000020
2200000000000000000000000000000000000020
2200000000001011111112000000001012000020
2200000000003031313132000000003032000020
2200000000000000000000000000000000000020
2200000000000000000000000000000000000020
2200000000000000000000000000000000000020
2200000000000000000000000000000000000020
2311111111111111111111111111111111111124

image image:3
sprite @9,3 sprite:goblin 0x00000000
sprite @7,3 sprite:goblin 0x00000000
sprite @3,9 sprite:hero 0x00000000
