1331313131313131313131313131313131313114
2200000000000000000000000000000000000020
2200000000000000000000000000000000000020
2200000000000000000000000000000000000020
2200000000000000000000000000000000000020
2200000000000000000000000000000000000020
2200000000000000101111120000001011111124
2200000000000000202121220000002021212121
2311111200000000202121220000002021212121
2121212200000000202121220000002021212121
2121212311111111242121220000002021212121

image image:3
sprite @2,7 sprite:hero 0x00000000
sprite @10,5 sprite:treasure 0x00000000
sprite @17,5 sprite:goblin 0x00000000
