1331313131313131313131313131313131313114
2200000000000000000000000000000000000020
2200000000000000000000000000000000000020
2200000000000000000000000000000000000020
2311111112000000000000000000000000000020
2121212122000000000000000000000000000020
2121212122000000101111120000001011111124
2121212122000000202121220000002021212121
2121212122000000202121220000002021212121
2121212122000000202121220000002021212121
2121212122000000202121220000002021212121

image image:3
sprite @2,3 sprite:hero 0x00000000
sprite @9,5 sprite:treasure 0x00000000
sprite @17,5 sprite:goblin 0x00000000
