1331313131313131313131313131313131313114
2200000000000000000000000000000000000020
2200000000000000000000000000000000000020
2200000000000000000000000000000000000020
2200000000000000000000000000000000000020
2200000000000000000000000000000000000020
2311111111120000101111120000101111111124
2121212121220000202121220000303131142121
2121212121220000202121220000000000202121
2121212121220000202121220000000000202121
2121212121220000202121220000101111242121

image image:3
sprite @9,5 sprite:hero 0x00000000
sprite @3,5 sprite:goblin 0x00000000
sprite @16,5 sprite:goblin 0x00000000
sprite @15,9 sprite:treasure 0x00000000
