1331313131313131313131313131313131313114
2200000000000000000000000000000000000020
2200000000000000000000000000000000000020
2311111112000000000000000000000000000020
2121212122000000000000000000000000000020
2121212123111111120000001011111112000020
2121212121212121220000003031313132000020
2121212121212121220000000000000000000020
2121212121212121220015161718191a1b1c0020
2121212121212121220025262728292a2b2c0020
2121212121212121231111111111111111111124

image image:3
sprite @2,2 sprite:treasure 0x00000000
sprite @3,2 sprite:goblin 0x00000000
sprite @6,4 sprite:goblin 0x00000000
sprite @13,9 sprite:hero 0x00000000
