1331313131313131313131313131313131313114
2200000000000000000000000000000000000020
2200000000000000000000000000000000000020
2200000000000000101112000000000000000020
2200001012000000303132000000000000000020
2200003032000000000000000000000000000020
2200000000000000000000000000101112000020
2200000000000000000000000000303132000020
2200000000000000003300000000000000000020
2200000000000000000000000000000000000020
2200000000000000000000000000000000000020

image image:3
sprite @3,3 sprite:hero 0x00000000
sprite @9,2 sprite:goblin 0x00000000
sprite @15,5 sprite:goblin 0x00000000
sprite @9,7 sprite:treasure 0x00000000
