1331313131313131313131313131313131313114
2200000000000000000000000000000000000020
2200000000000000000000000000000000000020
2200000000000000000000000000000000001024
2200000000000000000000101111111200003014
2200000000000000000000303131313200000020
2200000000101112000000000000000000000020
2200000000303132000000000000000000000020
2200000000000000000000000000000000000020
2200000000000000000000000000000000000020
2311111111111111111111111111111111111124

image image:3
sprite @2,9 sprite:hero 0x00000000
sprite @6,5 sprite:goblin 0x00000000
sprite @12,9 sprite:goblin 0x00000000
sprite @18,2 sprite:treasure 0x00000000
sprite @12,3 sprite:goblin 0x00000000
