1331313131313131313131313131313131313114
2200000000000000000000000000000000000020
2200000000000000000000000000000000000020
2200000000000000000000000000000000000020
2200000000000000000035000035000035000020
2200000010111200000045000045000045000020
2200000020212200000045000045000045000020
2200000020212200000045000045000045000020
2200000020212200000045000045000045000020
2200000020212200000045000045000045000020
2200000020212200000045000045000045000020

image image:3
sprite @5,4 sprite:hero 0x00000000
sprite @10,3 sprite:goblin 0x00000000
sprite @13,3 sprite:goblin 0x00000000
sprite @16,3 sprite:treasure 0x00000000
