1331313131313131313131313131313131313114
2200000000000000000000000000000000000020
2200000000000000000000000000000000000020
2200000000000000000000000000000000000020
2200000000001011111112000000001012000020
2233333300003031313132000000003032000020
2200000000000000000000000000000000000020
2200000000000000000000000000000000000020
2200000000000015161718191a1b1c0000000020
2200000000000025262728292a2b2c0000000020
2311111111111111111111111111111111111124

image image:3
sprite @9,3 sprite:goblin 0x00000000
sprite @7,3 sprite:goblin 0x00000000
sprite @16,9 sprite:hero 0x00000000
sprite @2,4 sprite:treasure 0x00000000
