2121212121212121212121212121212121212121
2121212121212121212121212121212121212121
2121212121212121212121212121212121212121
1331313131313131313131313131313131313114
2200000000000000000000000000000000000020
2200000000001011111111111111111111111124
2200000000003031313131311421212121212121
2200000000000000000000002021212121212121
2200000000000000000000002021212121212121
2311111111111111111111112421212121212121
2121212121212121212121212121212121212121

image image:tiles
sprite @8,8 sprite:hero 0x00000000
sprite @8,4 sprite:goblin 0x00000000
sprite @11,4 sprite:goblin 0x00000000
sprite @14,4 sprite:goblin 0x00000000
sprite @17,4 sprite:treasure 0x00000000
